codon	tri_code	sig_code	anmino
GCA	Ala	A	Alanine
GCC	Ala	A	Alanine
GCG	Ala	A	Alanine
GCT	Ala	A	Alanine
AAC	Asx	B	Asparagine or Aspartic acid
AAT	Asx	B	Asparagine or Aspartic acid
GAC	Asx	B	Asparagine or Aspartic acid
GAT	Asx	B	Asparagine or Aspartic acid
TGC	Cys	C	Cysteine
TGT	Cys	C	Cysteine
GAC	Asp	D	Aspartic acid
GAT	Asp	D	Aspartic acid
GAA	Glu	E	Glutamic acid
GAG	Glu	E	Glutamic acid
TTC	Phe	F	Phenylalanine
TTT	Phe	F	Phenylalanine
GGA	Gly	G	Glycine
GGC	Gly	G	Glycine
GGG	Gly	G	Glycine
GGT	Gly	G	Glycine
CAC	His	H	Histidine
CAT	His	H	Histidine
ATA	Ile	I	Isoleucine
ATC	Ile	I	Isoleucine
ATT	Ile	I	Isoleucine
AAA	Lys	K	Lysine
AAG	Lys	K	Lysine
CTA	Leu	L	Leucine
CTC	Leu	L	Leucine
CTG	Leu	L	Leucine
CTT	Leu	L	Leucine
TTA	Leu	L	Leucine
TTG	Leu	L	Leucine
ATG	Met	M	Methionine
AAC	Asn	N	Asparagine
AAT	Asn	N	Asparagine
CCA	Pro	P	Proline
CCC	Pro	P	Proline
CCG	Pro	P	Proline
CCT	Pro	P	Proline
CAA	Gln	Q	Glutamine
CAG	Gln	Q	Glutamine
AGA	Arg	R	Arginine
AGG	Arg	R	Arginine
CGA	Arg	R	Arginine
CGC	Arg	R	Arginine
CGG	Arg	R	Arginine
CGT	Arg	R	Arginine
AGC	Ser	S	Serine
AGT	Ser	S	Serine
TCA	Ser	S	Serine
TCC	Ser	S	Serine
TCG	Ser	S	Serine
TCT	Ser	S	Serine
ACA	Thr	T	Threonine
ACC	Thr	T	Threonine
ACG	Thr	T	Threonine
ACT	Thr	T	Threonine
GTA	Val	V	Valine
GTC	Val	V	Valine
GTG	Val	V	Valine
GTT	Val	V	Valine
TGG	Trp	W	Tryptophan
NNN	X	X	any codon
TAC	Tyr	Y	Tyrosine
TAT	Tyr	Y	Tyrosine
CAA	Glx	Z	Glutamine or Glutamic acid
CAG	Glx	Z	Glutamine or Glutamic acid
GAA	Glx	Z	Glutamine or Glutamic acid
GAG	Glx	Z	Glutamine or Glutamic acid
TAA	Ter	*	stop codon
TAG	Ter	*	stop codon
TGA	Ter	*	stop codon
